WE textures/rouge.xpm

EA textures/violet.xpm

NO textures/vert.xpm

SO textures/jaune.xpm

F 64,64,001

C 211,211,211

1111111111
10000E0001
1001110001
1011000001
1000000001
1111111111
