11111111
1E0000E1
1PEC0001
11111111
