11111111111111
1000000000001
1PEC0000000001
11111111111111
