111111
1CCCB1
1ECC11
10P001
111111

