11111111111111
10000000001C11
1P000000001111
1E000000000001
11111111111111
