11111111
1000C001
1P0000E1
11111111
