1111111
1EC1111
1PP0001
1111111
