11111111111111111
10000000000000001
1P0000010000000C1
1000001E100000001
11111111111111111
